~~~~~~~~
~......~
~.=....~
~..=...~
~...=..~
~=...=.~
~..=...~
~......~
~......~
~~~~~~~~