~~~~~~~~~~~~~
~====...====~
~====.=.====~
~===..=....=~
~====.====.=~
~====......=~
~=====.===.=~
~=====.....=~
~~~~~~~~~~~~~