~~~~~~~~~~~~~
~====...====~
~====.=.====~
~===..=....=~
~====.====.=~
~====......=~
~~~~~~~~~~~~~